###############################
#                             #
#                             #
#                             #
#                             #
#                             #
#                             #
#               ######        #
#                    #        #
#                    #        #
#                    #        #
#                             #
 LDDDDDDDDDDDDDDDDDDDDDDDDDDDE  
#                             #
#                             #
#                             #
#      #######                #
#                             #
#                             #
#                             #
#                             #
#                             #
#                             #
#                             #
#                             #
#                             #
#                             #
#                             #
#                             #
###############################